4

1.
0 0 1 1 1 1 1 0
1 1 1 0 0 0 1 0
1 4 2 3 0 0 1 0
1 1 1 0 3 4 1 0
1 4 1 1 3 0 1 0
1 0 1 0 4 0 1 1
1 3 0 5 3 3 4 1
1 0 0 0 4 0 0 1
1 1 1 1 1 1 1 1.

2.
1 1 1 1 1 1 1 1 1 1 1 1
1 1 1 1 1 1 1 1 0 3 4 1
1 1 1 1 1 1 1 1 0 1 0 1
1 1 1 1 1 1 0 4 0 0 0 1
1 0 0 0 1 1 4 1 1 0 0 1
1 0 1 0 3 0 0 1 1 0 4 1
1 0 0 0 0 4 0 1 1 3 3 1
1 0 2 0 1 1 0 0 0 0 0 1
1 0 3 0 1 1 0 1 0 1 1 1
1 0 0 0 1 1 0 0 0 1 1 1
1 0 0 0 0 0 0 1 1 1 1 1
1 1 1 1 1 1 1 1 1 1 1 1

3.
1 1 1 1 1 1 1 1 1 1 1 1 1 1
1 0 0 0 1 1 1 1 1 1 1 1 1 1
1 0 1 0 1 1 1 1 1 1 1 1 1 1
1 0 1 0 0 0 3 0 1 1 1 1 1 1
1 0 4 0 0 1 1 0 1 1 1 1 1 1
1 0 1 1 0 1 1 0 0 0 1 1 1 1
1 0 4 0 0 4 3 4 3 0 1 1 1 1
1 1 1 1 1 1 1 0 0 0 3 2 0 1
1 1 1 1 1 1 1 0 0 0 1 1 0 1
1 1 1 1 1 1 1 1 1 0 0 5 0 1
1 1 1 1 1 1 1 1 1 1 1 1 1 1

4.
1 1 1 1 1 1 1 1 1 1 1 1 1 1
1 0 0 0 0 0 1 1 1 1 1 1 1 1
1 0 1 1 1 0 1 1 1 1 1 1 1 1
1 0 0 1 1 0 1 1 0 0 0 0 1 1
1 0 3 0 0 0 4 1 4 1 1 0 1 1
1 1 2 3 0 0 0 5 0 1 1 0 1 1
1 1 1 1 1 0 5 3 0 0 0 0 4 1
1 1 1 1 1 0 0 1 0 0 5 0 1 1
1 1 1 1 1 1 1 1 1 1 1 1 1 1}
